b12
110000111000
000*01010101
0101001011*0
1101*1010001
010101*10101
110111*10010
110*10101000
10000*111001
1110100*0100
111*00110111
100001111010
000010*00001
001000111100
1001000101*0
10*111110101
110011101*00
111111*10110
000110*11110
100000000100
100111001111
11010110*100
1011*1111111
*00*01100001
000011111001
101110001100
101111001010
10100000001*
000000010010
0*0100101100
11011101*110
01*011101010
*01011010011
011001111*11
101*01110100
110011*00001
01*110001011
01111011*000
01*110010000
0101001*0110
1110001*0001
011111101*00
101000000*11
110010110001
00*010000000
0000111000*1
10011000*000
01000*101101
0100111*1010
100000001101
01001000100*
1010101100*0
011100111*01
000111011001
110111010*10
110010101111
11001110*000
0001100*1110
10*000000111
011100100100
100010010101
00100*011001
0001101011*1
110010100100
01111*101000
011010110001
10010010*001
111101010010
001010110100
1010111010*0
111101110011
11100011*001
010010*10000
101001011010
*00101001101
111*11101000
111000000000
0000*1001000
110101110000
111111101011
0011*0001000
01111000000*
001001011*01
100110010001
*11011110000
00000010*110
101000*00011
110*11101101
11100*100001
010*10101010
010101101010
*00010001011
010*00110110
100111000100
00*100100011
011010011010
*00110100101
1001100*1000
001*00011001
0010*1110101
1011101101*0
111010001101
000010*10011
1001*0100101
0010111101*1
001101110110
10011110001*
01000000000*
*01000000010
010011011000
*00010000000
01*001000010
*00100000000
0*0101010101
111101100000
000001001011
1001*1101000
00011010*101
000101011011
011000000100
00*010101111
111*00010011
*11100101011
0110*1101010
001*10001000
010*11111010
111101001010
101100010101
110101111010
010*11000110
10110111*000
111010110011
01101110101*
0010*0010011
010*00000001
1010111*1010
111100110100
00101110*101
100*11100011
111110011000
101111011101
1001111000*1
111001100111
001001101000
*01011000110
0111101*1000
011111010111
011101001001
11*100111001
110000001110
010011010011
010110000*10
0000**100001
110100110011
111001111100
010000*00001
*11010001000
111110101111
001001010000
01010010*110
01*010001000
001101100010
100011000101
101010011010
1010000001*1
1000011000*1
1100110000*1
11*011101000
1010*0011101
000001110110
111000011110
00011101011*
11*111010110
01*101100011
0100*0000001
110110111100
01000*000111
00100001010*
100011111100
011011*01100
110001110001
0*0100011000
11100*010011
111*11110000
*00011100011
111011111110
1010*0101111
010*10010000
0110110011*0
100001010010
110011010111
1010001*1111
10*110100101
001101000110
00101*010011
00*010010011
101111111*11
00101000100*
11001*101000
1001*0000000
10100010100*
110001101001
011110*00001
101101000101
11001101101*
011110110111
001011101*01
*11111101000
111011100100
111*00111001
001100001111
100*00000111
111010101*10
111101010111
001101100101
1001*0100110
110010011001
01110011110*
001110001101
001100100000
0100110*0110
1001011010*0
110111111001
0000110010*0
10*111101110
010011001111
100001*00011
110010111010
101001010101
000000101000
0110*1111111
11001110110*
01001000*001
010111110001
11100011000*
011010001*00
000111101010
000100111010
0100000*0001
101001110111
11111*100010
101000*11111
100011011001
*01101111000
110011100111
10011*000011
00101000*000
111110111011
0*1010001000
10001*001011
111010100111
001010*11111
011011011011
1*0010001011
001*01101110
0111100*0000
1001*0101001
*11111011100
101111001001
000001111100
010110100100
010011000000
100001110101
0*0010000001
000*10100001
110000100110
10011111010*
1110*1110101
*00110000011
00001000000*
100101*01101
1000*11*0011
11011*101101
01011001000*
1*0010000000
000111111111
01101*001100
10*010001011
01100*111011
011110001110
001000110111
000101011100
10010*100001
110000111011
*01010101111
000*10101111
110*00010111
1110100001*0
0*0000100001
01001*011101
100000101010
101101**1111
0001*0011110
*11100111001
101*11010011
011001011100
01*011010110
01100000101*
1001001*0*01
111001001110
000011011110
010001111110
011101010011
011*11101100
0010101*1111
101010001110
011111110011
0101001101*0
*00100110101
111*11011100
101101110*00
011110011001
000110100*01
100*10000000
111111010101
111100011111
011110*100*0
110110001110
001110000111
000000000101
001000110001
10101100110*
01011*000110
01001*101010
101*01011111
010111101110
11100*001001
11001110000*
010000011100
100111*00011
0110011111*1
011001100110
001110011011
0010111*0101
01101110*010
1*1011101000
100001101111
100010101110
1001*1100001
1*0100100001
1010*0110101
0001101*1000
1011001111*0
1010000111*1
11000100101*
*10100010111
101100000100
010111000011
101110011001
00010001111*
001001000111
01*111011100
010100101*00
1*1010000100
11000011010*
10100*011111
111110000011
